1 1 1 1 1 1 1 1 1 2
6 1 1 1 1 1 1 1 4 5
6 1 1 1 1 1 2 3 4 4
1 1 1 1 1 1 1 1 3 3
1 1 1 1 1 1 1 1 1 1
1 1 1 1 1 1 1 1 1 1
6 1 1 1 1 1 2 3 4 4
6 1 1 1 1 1 2 3 4 4
6 1 1 1 1 1 2 3 4 4
6 1 1 1 1 1 2 3 4 4